데이터 정제 과정

1. 현재 수치지도를 정제할 때 사용한 면적 기준과 동일한 기준으로 previous 수치지도에서도 해당 면적에 해당하는 건물을 제거하였음.
2. 현재 수치지도를 정제할 때 선택한 제거 유형과 동일한 위치에 있는 건물도 제거되었음.








			██████████▀▀▀▀▀▀▀▀▀▀▀▀▀██████████
			█████▀▀░░░░░░░░░░░░░░░░░░░▀▀█████
			███▀░░░░░░░░░░░░░░░░░░░░░░░░░▀███
			██░░░░░░░░░░░░░░░░░░░░░░░░░░░░░██
			█░░░░░░▄▄▄▄▄▄░░░░░░░░▄▄▄▄▄▄░░░░░█
			█░░░▄██▀░░░▀██░░░░░░██▀░░░▀██▄░░█
			█░░░██▄░░▀░░▄█░░░░░░█▄░░▀░░▄██░░█
			██░░░▀▀█▄▄▄██░░░██░░░██▄▄▄█▀▀░░██
			███░░░░░░▄▄▀░░░████░░░▀▄▄░░░░░███
			██░░░░░█▄░░░░░░▀▀▀▀░░░░░░░█▄░░░██
			██░░░▀▀█░█▀▄▄▄▄▄▄▄▄▄▄▄▄▄▀██▀▀░░██
			███░░░░░▀█▄░░█░░█░░░█░░█▄▀░░░░███
			████▄░░░░░░▀▀█▄▄█▄▄▄█▄▀▀░░░░▄████
			███████▄▄▄▄░░░░░░░░░░░░▄▄▄███████